 ####### ########### ################# # 
#.......#...........#.................#.#
#.#####.#.#######.#.#.###.###########.#.#
#.....#.#.#...#...#.#.#...#.........#...#
 ######.#.###.#.###.#.#####.#######.#### 
#...#...#...#.#.#.....#...#.#...#...#...#
#.#.#.#####.#.#.#.#####.#.#.###.#.###.#.#
#.#...#...#...#.#.#.....#...#.D.#.#...#.#
#.#####.#.###.#.###.#########.###.#.###.#
#.......#.....#...#.......#...#...#.#...#
 ##############.#.#######.#.#.#.###.#.## 
#.....#.......#.#.....#...#.#.#...#.#.#.#
#.###.#.#####.###.#.#.#.###.#.###.#.#.#.#
#.#.....#...#...#.#.#.#.#...#...#.#.#...#
#.#######.#####.###.#.#.#.## ##.#.#.###.#
#.....#...#.........#.#.#...#...#...#...#
#.###.###.#.#########.#.###.#### ####.## 
#.#.#...#...#...#.#...#...#.....#...#...#
#.#.###.#.###.#.#.#.#####.#####.#.#.###.#
#.....#.#...#.#.#...#.....#.....#.#.....#
 ####.#.###.#.#.#####.#####.#####.###### 
#...#.#.#...#.#.....#A#...........#.....#
#.###.#.#####.#####.###.#############.#.#
#.#...#.........#...#...#.............#.#
#.#.#############.###.#########.#.###### 
#.#.#...#.#.....#...#.#.......#.#.#.....#
#.#.#.#.#.#.###.###.#.#.#####.#.###.###.#
#...#.#...#.#.......#.#.#...#...#.....#.#
#.###.###.#.#######.#.#.#.###.###.#####.#
#.#...#...#.#...#...#.#.#.....#...#.....#
#.#.###.###.#.#.###.#.#.###.###.###.#### 
#...#...#...#.#...#.#.#...#...#.#.#.....#
 ####.###.###.###.###.#.#.#####.#.#####.#
#...#...#.....#.#...#.#.#.#...........#.#
 ##.###.#######.###.#.###.#.#######.###.#
#...#...#.......#...#...#...#...#o..#...#
#.###.#########.#.#.###.#####.#.#####.#.#
#.#...#.......#.#.#.#...#...#.#...#...#.#
#.#.###.#####.#.#.###.###.#.#.###.#.###.#
#.......#.......#.........#...#.....#...#
 ####### ####### ######### ### ##### ### 
